01 Januar	Neujahr
04 Januar	Tag der Spaghetti
05 Januar	Nationaler Tag des Vogels
06 Januar	Afrikatag Tag des Kuschelns
Heilige Drei Könige
08 Januar	Räume-Deinen-Schreibtisch-auf-Tag 
Tag des Schaumbades
09 Januar	Spiele-Gott-Tag
10 Januar	Tag der Blockflöte
Tag der Zimmerpflanze
11 Januar	Tag des deutschen Apfels
12 Januar	Tag des Marzipans
13 Januar	St. Knut Tag 
Tag des Quietscheentchens
14 Januar	Schaff-Ordnung-in-Deiner-Wohnung-Tag
15 Januar	Tag der Wikipedia
16 Januar	Nichts-Tag
17 Januar	Wirf-Deine-Jahresvorsätze-über-Bord-Tag
Tag der italienischen Küche
Geburtstag der Kunst
18 Januar	Reichsgründungstag
19 Januar	Tag des Popcorns
Weltreligionstag
Tag der Konservendose
20 Januar	Martin Luther King Tag
21 Januar	Weltknuddeltag
Internationaler Tag der Jogginghose
22 Januar	Feiere-das-Leben-Tag
Tag der scharfen Saucen
23 Januar	Tag der Handballer
Nationaltag der Handschrift
24 Januar	Botschaft zum Welttag der sozialen Kommunikationsmittel
25 Januar	Gegenteiltag
Ehegattentag
26 Januar	International Customs Day
Saatgut-Tausch-Tag
27 Januar	Tag des Schokoladenkuchens
Tag der Alphabetisierung
28 Januar	Europäischer Datenschutztag
Spaß-bei-der-Arbeit-Tag
Tag des Blaubeerpfannkuchen
29 Januar	Internationaler Puzzle-Tag
Tag der Freidenker
30 Januar	Tag des Croissants
31 Januar	Rückwärts-Tag
01 Februar	Ändere-Dein-Passwort-Tag
Dekoriere-mit-Süßigkeiten-Tag
02 Februar	Tag des Igels
03 Februar	Eis-zum-Frühstück-Tag
04 Februar	Weltkrebstag
05 Februar	Tag der Meteorologen
06 Februar	Tag der lahmen Ente
07 Februar	Schick-einem-Freund-eine-Karte-Tag
Tag der Rose
08 Februar	Reinige-Deinen-Computer-Tag
09 Februar	Tag der Zahnschmerzen
10 Februar	Tag des Regenschirms 
Tag des Teddys
11 Februar	Safer Internet Day
12 Februar	Internationaler Darwin-Tag
13 Februar	Welttag des Radios
Tag der Tortellini
Tag des Kusses
Tag des Wals
14 Februar	Valentinstag
Verschenk-ein-Buch-Tag
15 Februar	Kinderkrebstag
16 Februar	Tag der Mandel
17 Februar	Tag des menschlichen Geistes
Tag der grundlosen Nettigkeiten
18 Februar	Trinke Wein Tag
19 Februar	Tag der Minzschokolade
20 Februar	Welttag der sozialen Gerechtigkeit
Liebe-Dein-Haustier-Tag
21 Februar	Internationaler Tag der Muttersprache
22 Februar	Sei-Bescheiden-Tag 
Tag der Margarita
23 Februar	Spiel-Tennis-Tag
Tag des Hundekuchens
24 Februar	Tag der Schwertschlucker
25 Februar	Tag der Schachtelsätze
26 Februar	Tag der Pistazie
27 Februar	Weiberfastnacht
28 Februar	Tag der Floristik
Schlaf-in-der-Öffentlichkeit-Tag
01 März	Frühlingsanfang (meteorologisch) 
Zero Discrimination Day
Welttag des Buches 
Welttag des Kompliments
02 März	Faschingssonntag 
Tag der Verkäufer 
03 März	Rosenmontag
Welttag des Hörens 
Tag des Artenschutzes
04 März	Faschingsdienstag 
05 März	Aschermittwoch 
06 März	Tag der ungewöhnlichen Namen 
Oreo-Tag
07 März	Tag der gesunden Ernährung
08 März	Internationaler Frauentag
10 März	Tag der Großartigkeit
11 März	Tag der Rohrleitung
12 März	Welttag gegen Internetzensur
13 März	Weltnierentag
14 März	Pi-Tag
Stell-eine-Frage-Tag
15 März	Weltverbrauchertag
16 März	Tag der Informationsfreiheit
17 März	St. Patricks Day
18 März	Tag der peinlichen Momente
19 März	Frühstück-am-Arbeitsplatz-Tag
20 März	Weltgeschichtentag
Weltglückstag
21 März	Weltschlaftag
Welttag der Poesie
22 März	Weltwassertag
23 März	Tag der Welpen
25 März	Tag der Waffel
26 März	Purple Day
27 März	Welttag des Theaters
28 März	Tag der Schwarzwälder Kirschtorte
29 März	Tag des Zitronenkuchens
30 März	Umstellung auf Sommerzeit
01 April	April Fools Day
02 April	Internationaler Kinderbuchtag
03 April	Welt-Party-Tag
06 April	Welt-Olympiatag
Karamell-Popocorn-Tag
07 April	Weltgesundheitstag
08 April	Welttag für die Berufung
09 April	Gib-Dir-einen-Namen-Tag
10 April	Tag der Geschwister
11 April	Tag der Haustiere
12 April	Tag der Kosmonauten
13 April	Ehrentag der Pflanze
14 April	Momente-des-Lachens-Tag
15 April	Kuckuckstag
16 April	Tag der Stimme
17 April	Gründonnerstag
18 April	Karfreitag 
Internationaler Denkmaltag
19 April	Record Store Day
20 April	Ostersonntag
21 April	Ostermontag
22 April	Tag der Erde
23 April	Tag des Deutschen Bieres
24 April	Girls Day
25 April	Metricool Tag
26 April	Welttag des geistigen Eigentums
27 April	Welt-Grafiker-Tag
29 April	Welttag des Tanzes
30 April	Walpurgisnacht 
Tag der Ehrlichkeit 
01 Mai	Tag der Arbeit
02 Mai	Tag des Babys
03 Mai	Tag der Sonne
04 Mai	Ohne-Hose-Tag
Star-Wars-Tag
Weltlachtag
05 Mai	Welttag der Handhygiene
06 Mai	Welt-Asthma-Tag
08 Mai	Ohne-Socken-Tag
09 Mai	Tag der verlorenen Socke
10 Mai	Weltzugvogeltag
11 Mai	Muttertag
Iss-was-du-willst-Tag
12 Mai	Internationaler Tag der Pflege
13 Mai	Internationaler Tag des Cocktails
14 Mai	Tag der Kinderbetreuung
15 Mai	Internationaler Tag der Familie
16 Mai	Internationaler Tag des Lichts
17 Mai	Welt-Whiskey-Tag
18 Mai	Kein-schmutziges-Geschirr-Tag
19 Mai	Malcolm-X-Tag
20 Mai	Weltbienentag
21 Mai	Welttag für kulturelle Entwicklung
22 Mai	Internationaler Tag der biologischen Vielfalt
23 Mai	Welt-Schildkröten-Tag
24 Mai	Tag des Parks
25 Mai	Tag des Handtuches
27 Mai	Tag der Sonnencreme
28 Mai	Internationaler Weltspieltag
29 Mai	Vatertag
Christi Himmelfahrt
31 Mai	Weltnichtrauchertag
01 Juni	Sommeranfang
Internationaler Kindertag
02 Juni	Ich-liebe-meinen-Zahnarzt-Tag
03 Juni	Weltfahrradtag
04 Juni	Umarme-deine-Katze-Tag
05 Juni	Welttag der Umwelt
06 Juni	Tag des Donut
07 Juni	Pfingstsamstag 
08 Juni	Pfingstsonntag 
Tag des Meeres
09 Juni	Pfingstmontag
10 Juni	Kindersicherheitstag
14 Juni	Flag Day
15 Juni	Autofreier Sonntag
16 Juni	Tag des afrikanischen Kindes
18 Juni	Autistic Pride Day
19 Juni	Fronleichnam
20 Juni	Tag der Flip Flops
21 Juni	Internationaler T-Shirt-Tag
Tag des Schlafes
22 Juni	Internationaler Motorrad Tag
23 Juni	Tag des öffentlichen Dienstes
24 Juni	Johannistag
25 Juni	Tag des Seefahrers
27 Juni	Weltdufttag
28 Juni	Tag der Versicherungen
29 Juni	Tag des Waffeneisens 
30 Juni	Tag des Meteors
01 Juli	Tag der Früchte
02 Juli	Tag des Ufos
06 Juli	Internationaler Tag des Kusses
07 Juli	Tag der Schokolade
11 Juli	Weltbevölkerungstag
12 Juli	Tag der Einfachheit
16 Juli	Tag des Hotdogs
Weltschlangentag
17 Juli	Internationaler Tag der Gerechtigkeit
18 Juli	Nelson-Mandela-Tag
20 Juli	Weltraumforschungstag
22 Juli	Tag der Hängematte
25 Juli	Tag des Systemadministrators
26 Juli	Internationaler Tag der Netzhaut
27 Juli	Tag der Seenotretter
29 Juli	Tag des Tigers
30 Juli	Tag der Freundschaft
01 August	Internationaler Tag des Bieres
Tag des Lungenkrebs
08 August	Weltkatzentag
12 August	Tag der Jugend
15 August	Mariä Himmelfahrt
16 August	Tag der Bratwurst
20 August	Weltpferdetag
22 August	Tag der Fische
25 August	Welt-Tofu-Tag
01 September	Herbstanfang (meteorologisch)
03 September	Wolkenkratzertag
05 September	Kopfschmerztag 
Tag der Wohltätigkeit
08 September	Weltbildungstag
09 September	Tag des Wiener Schnitzels
13 September	Tag der Ersten Hilfe
Tag der deutschen Sprache
14 September	Tag der Heimat
16 September	Deutscher Tafel-Tag
17 September	Tag der Patientensicherheit 
18 September	Tag des Cheeseburgers
19 September	Sprich-Wie-Ein-Pirat-Tag
20 September	Oktoberfest beginnt
21 September	Weltfriedentag
24 September	Tag der Sauna
27 September	Welthasentag
Welttourismustag
30 September	Tag des Übersetzers
01 Oktober	Tag des Kaffees 
Weltmusiktag
03 Oktober	Tag der Deutschen Einheit
Welttag des Lächelns
04 Oktober	Welttierschutztag
05 Oktober	Erntedankfest 
Weltlehrtag
09 Oktober	Tag des Weltpostvereins
10 Oktober	Welthundetag
16 Oktober	Welttag des Brotes
18 Oktober	Tag der Krawatte
25 Oktober	Weltnudeltag
31 Oktober	Reformationstag
Halloween
01 November	Allerheiligen 
Weltvegantag
08 November	Tag der Putzfrau
10 November	Welttag der Wissenschaft
13 November	Weltnettigkeitstag
14 November	Weltdiabetestag
15 November	Putz-Deinen-Kühlschrank-Tag
17 November	Weltstudententag
19 November	Welttoilettentag
20 November	Philosophie
21 November	Tag des Fernsehens
27 November	Thanksgiving
28 November	Black Friday
29 November	Kauf-Nix-Tag
30 November	Erster Advent 
1 Dezember	Winteranfang (meteorologisch)
Welt AIDS Tag
Cyber Monday
04 Dezember	Tag der Kekse
06 Dezember	Nikolaustag
07 Dezember	Zweiter Advent
10 Dezember	Tag der Menschenrechte
13 Dezember	Eiscreme Tag
14 Dezember	Dritter Advent
16 Dezember	Tag des dummen Spielzeugs
20 Dezember	Sangria-Tag
21 Dezember	Vierter Advent
24 Dezember	Heiligabend
25 Dezember	Erster Weihnachtstag
26 Dezember	Zweiter Weihnachtstag
31 Dezember	Silvester
